Adieu Gary Cooper 
Adolphe 
Agamemnon|Agamemnon d' Eschyle
Alceste|Alteste
Alexis ou le traité du vain combat|Alexis de Mme Yourcenar|Traité du Vain Combat|Traité
Anabase 
Anna Karénine 
Anna soror|Soror
Antichita romane|Antichita
Antigone|Antigone d' Anouilh
Apistia|Apistia de Cavafy
Archives du Nord|ARCHIVES DU NORD de Marguerite Yourcenar|Archives du Nord37|Archives du Nord47|A.N
Bacchus|Bacchus de Vinci
Bajazet|Bajazet
Ballade de Sacramento Slim 
Bardo Thödol 
Belle du Seigneur 
Blancador l'avantageux|Blancador
Blues et Gospels|Gospels
Blues et gospels|Blues
Bruges-la-Morte|Bruges-la-morte
Bérénice 
Carnet de notes de Mémoires d'Hadrien|C.M.H
Carnets|Cahiers de Léonard
Carnets de notes de Mémoires d'Hadrien|Carnets de Notes|Carnets de Notes
Ce que Maisy savait|Maisy
Cinq nô modernes|Cinq
Combats avec tes défenseurs|Combats
Confessions|Confessions de Rousseau
Conte du Genji|Genji Monogatari
Correspondance|Correspondance de Liévin
Cortège d' Ombres 
Corydon 
D'après Greco|Greco
Denier du Rêve|DENIER DU REVE de Marguerite Yourcenar|DENIER DU RÊVE de Marguerite YOURCENAR
Denier du rêve|Denier du Rêve de Mme Yourcenar|Dernier du Rêve
Dessins (Goya)|Dessins
Deux nègres|Deux Nègres de Rembrandt
Diagnostic de l'Europe|Diagnostique de‧l' Europe
Diagnostic de‧l' Europe 
Désert|Désert de J.-M.G
El Verduyo 
Electre ou la chute des masques|Chute
En pèlerin et en étranger|Pèlerin
Enéide 
Feux 
Fleuve profond, sombre rivière|Fleuve Profond
Fragments 
Gita-Govinda 
Gîta-Govinda 
Hamlet|Hamlet
Idylles|Idylles de Théocrite
Illiade|Iliade
Illuminations|Illuminations de Rimbaud
Innsbrück|Innsbruck
Inédits|Inédits de Cavafy
Joseph et ses frères|Joseph de Thomas Mann
Journal de César 
Karamazov 
Kâli décapitée|Kâli
L'Affaire Mauritzius|Affaire Mauritzius
L'Ardoise et la craie|Craie
L'Atelier de Marie-Claire|Atelier de Marie-Claire
L'Ecclésiaste|Ecclésiaste
L'Heptaméron|Heptaméron
L'Histoire Auguste|Histoire Auguste|Histoire-Auguste
L'Immoraliste|Immoraliste
L'Oracle de Delphes|Oracle de Delphes
L'Orestie|Orestie
L'île des dragons|Dragon
La Belle-Hélène|Belle Hélène
La Canne de jaspe|Canne de Jaspe
La Chanson de Roland|Chanson de Roland
La Chartreuse de Parme|Chartreuse de Parme
La Couronne et la lyre|Couronne|Lyre
La Dame de Pique|Lu Dame de Pique
La Double méprise|Double Méprise
La Flûte enchantée|Flûte
La Gloire de Ramire|Gloire de Ramire
La Maison de Kyoko|Maison de Kyo
La Mauvaise fréquentation|Mauvaise Fréquentation
La Mer de la fertilité|Mer de‧la Fertilité
La Mort conduit l'attelage|Attelage
La Nouvelle Euridice|Nouvelle Euridice|Nouvelle Eurydice|Nouvelle Euridyce
La Petite Marchande d'allumettes|Petite Marchande
La Petite Sirène|Petite Sirène
La Princesse de Clèves|Princesse de Clèves
La Promenade au phare
La Recherche du temps perdu|Recherche
La Sonate à Kreutzer|Kreutzer
La Sympahonie héroïque|Symphonie
La Tentation de Saint-Antoine|Tentation de Saint-Antoine
La Victoire de Samothrace|Victoire de Samothrace
La Vie d'Euripide|Vie d' Euripide
La Vie de Rancé|Vie de Rancé
La Voix des choses|LA VOIX DES CHOSES
La chambre de Jacob|Chambre de Jacob
La tentative amoureuse ou le traité du vain désir|Traité du Vain Désir
Le Bateau ivre|Bateau
Le Cavalier polonais|Cavalier
Le Coup de grâce|Coup de Grâce
Le Cousin Pons|Cousin Pons
Le Dernier amour du prince Genghi|Dernier Amour du Prince Genghi
Le Diable amoureux|Diable Amoureux
Le Dialogue dans le marécage|Dialogue
Le Docteur Faustus|Docteur Faustus
Le Labyrinthe du monde|Labyrinthe
Le Lys dans la Vallée|Vallée
Le Lys dans la vallée|Lys
Le Mendiant de Jérusalem|Mendiant de Jérusalem
Le Mystère d'Alceste|Mystère d' Alceste
Le Premier Soir|Premier Soir
Le Rideau cramoisi|Rideau
Le Roi au masque d'or|Masque d' Or
Le Temps ce grand sculpteur|Approches du Tantrisme|Noblesse de‧l' Echec|Sixtine
Le Tour de la prison|Voyages
Le Tournoi de Vauplassans|Tournoi de Vauplassans
Le colosse de Maroussi|Colosse de Maroussi
Lectures de Marguerite Yourcenar. Mémoires d'Hadrien|Lectures de Marguerite Yourcenar
Les Antiquités de Rome|Antiquités de Rome
Les Bucoliques|Eglogues de Virgile
Les Buddenbrook|Buddenbroke
Les Caves du Vatican|Caves du Vatican
Les Charités d'Alcippe|Charités d' Alcippe|Chantés d' Alcippe
Les Choéphores|Choéphores
Les Châtiments|Châtiments
Les Diaboliques|Diaboliques
Les Gens de la clairière|Gens de‧la Clairière
Les Histoires magiques|Histoires Magiques
Les Ides de Mars|Ides de Mars de Thornton Wilder|Ides de Mars
Les Mille et une nuits|Mille
Les Nourritures terrestres|Nourritures
Les Nouvelles Orientales|Veuve Aphrodéssia
Les Nouvelles orientales|Nouvelles Orientales|Sourire de Marko|Comment Wang-Fô
Les Oiseaux|Oiseaux d' Aristophane
Les Songes et les sorts|Songes
Les Tragiques|Tragiques d' Agrippa d' Aubigné
Les Troyens|Troyens de Cavafy
Les Vagues|Vagues de Virginia Woolf|LES VAGUES|Waves
Les Verts paturages|Verts Pâturages
Les Yeux ouverts|Yeux
Les prisons imaginaire|Prisons de Piranèse
Les sables rouges|Sables
Les songes et les sorts|Sorts
Louis Lambert 
Maléfice 
Manuel d'Épictète|Manuel de Marc-Aurèle
Marie-Claire|Mark-Claire
Moi Claude 
Moi Claudio|Claudio
Mon Faust 
Mrs Dalloway 
Méditations poétiques|Méditations
Méduse et cie|Méduse
Mémoires|Mémoires d' Ambroise Paré
Mémoires d' Hadrien|Mémoires d' Hadrien de Marguerite Yourcenar|Mémoires d' Hadrien de Marguerite Yourcenar
Mémoires d'Hadrien|Aux Mémoires d' Hadrien
Mémoires d'outre-tombe|Outre Tombe
Negro Spirituals 
Niels Lynhe 
OEUVRE AU NOIR
Odyssée
Oncle Vania 
Orlando 
Pensées pour moi-même|Pensées de Marc Aurèle
Pindare|Biographie de Pindare
Prisons 
Prolégomènes 
Présentation Critique d' Hortense Flexner|Hortense Flexner de Mme Marguerite Yourcenar|PRÉSENTATION CRITIQUE D' HORTENSE FLEXNER
Présentation Critique de Constantin Cavafy 
Psyché|Psyché du Musée de Naples
Pyrrhos et Pyrrha|Pyrrha
Qui n'a pas son Minautore ?|Minotaure
Quo vadis ?|Quo Vadis
Quoi ? L'éternité|Eternité
Recherche du Temps perdu
Rendre à César|Rendre
Rosario 
Saint-Sébastien|Saint Sébastien de Guido Reni
Salammbô
Second Faust|Second Faust
Soleil vert|Soleil Vert
Sotoha Komachi|Nô Sotoha Komachi
Sous bénéfice d'inventaire|SOUS BÉNÉFICE D' INVENTAIRE|S.B.I
Souvenirs Pieux|Souvenirs
Souvenirs Pieux 
Souvenirs pieux|S.P
Séraphîta|Seraphîta
Tannhaüser 
The Seven who fled|Seven Who Fled
Thésée|Thésée d' André Gide
Théâtre I|THÉÂTRE I|THEATRE I
Théâtre II|THÉÂTRE II
Théâtre II 
Télémaque 
Unamateur d'âmes|Amateur d' Ames
Utopie|Utopie de Thomas More
Valérie|Valérie de Mme de Krüdener
Vie et opinions de Tristram Shandy|Tristram Shandy de Sterne
Virage à 80|Virage
Vous, Marguerite Yourcenar. La passion et ses masques|Marguerite Yourcenar de Michèle Sarde
Voyage au phare|Voyage
Voyage de Thésée|Voyage de Thésée de Georges Neveux
Voyage du jeune Anacharsis en Grèce|Jeune Anacharsis
What Maisie knew|What Maisy
Wuthering Height
Églogues|Eglogue de Virgile
Électre|Electre d' Euripide
Électre ou la chute des masques|Electre
Élégies de Buckow|Elégies de Buckow
Évangiles|Evangiles
